~   ####                                                                                                       ####   ~
  ▓##▓##▓  ▓  ▓  ▓ #▓  ▓ #▓# ▓ #▓# ▓ #▓# ▓ #▓# ▓ #▓# ▓ #▓# ▓ #▓# ▓  ▓  ▓  ▓  ▓  ▓  ▓  ▓  ▓  ▓  ▓  ▓  ▓ #▓ #▓  ▓##▓##▓
########                                                                                               ###      #######
##▓##▓  ▓  ▓  ▓  ▓ #▓  ▓ #▓# ▓ #▓# ▓ #▓# ▓ #▓# ▓ #▓# ▓ #▓# ▓ #▓# ▓  ▓  ▓  ▓  ▓  ▓  ▓  ▓  ▓  ▓  ▓  ▓  ▓ #▓ #▓  ▓  ▓##▓##
#####    # #         #  # # # # # # # # # # # # # # # # # # # #                ####                    ###       ######
 #▓##▓  ▓ #▓  ▓  ▓  ▓  ▓  ▓  ▓  ▓  ▓  ▓  ▓  ▓  ▓  ▓  ▓  ▓  ▓  ▓  ▓  ▓  ▓  ▓  ▓  ▓  ▓  ▓  ▓  ▓  ▓  ▓  ▓  ▓  ▓  ▓ #▓  ▓
 ##                                                                            #   #                    ##       ###
  ▓  ▓ #▓  ▓  ▓ #▓ #▓  ▓  ▓  ▓  ▓  ▓  ▓  ▓  ▓  ▓  ▓  ▓  ▓  ▓  ▓  ▓  ▓  ▓  ▓  ▓  ▓  ▓  ▓  ▓  ▓  ▓  ▓  ▓  ▓  ▓  ▓  ▓  ▓
     # #   # #                                                                                        ##    ###
  ▓ #▓ #▓ #▓  ▓  ▓ #▓# ▓##▓  ▓ #▓# ▓##▓##▓##▓  ▓##▓##▓ #▓# ▓  ▓##▓ #▓  ▓##▓  ▓  ▓  ▓  ▓  ▓ #▓  ▓  ▓  ▓  ▓  ▓  ▓  ▓  ▓
             # #   ###  ###    ###  #########  ######  ###     ###     ###          ####                       ## ##
  ▓  ▓  ▓  ▓  ▓  ▓ #▓# ▓##▓##▓ #▓# ▓  ▓##▓  ▓  ▓##▓  ▓ #▓# ▓  ▓##▓  ▓  ▓##▓  ▓  ▓  ▓  ▓  ▓ #▓  ▓  ▓  ▓  ▓  ▓  ▓  ▓  ▓
             #     ###  ### ## ###     ###     #####   ###     ###     ###          #####               ##    ##   ###
  ▓  ▓  ▓  ▓  ▓  ▓ #▓# ▓##▓  ▓##▓# ▓  ▓##▓  ▓  ▓##▓  ▓ #▓# ▓  ▓##▓  ▓  ▓##▓  ▓  ▓  ▓  ▓  ▓ #▓  ▓  ▓  ▓  ▓  ▓  ▓  ▓  ▓
         ### #     ###  ###   ####     ###     ######  ######  ######  ###          ####               ##   ####   ###
  ▓  ▓  ▓  ▓ #▓ #▓ #▓# ▓##▓  ▓ #▓# ▓  ▓##▓  ▓  ▓##▓##▓ #▓##▓# ▓##▓##▓  ▓##▓  ▓  ▓  ▓##▓  ▓ #▓  ▓  ▓  ▓  ▓  ▓  ▓  ▓  ▓
                                                                                   #######                 #####
  ▓  ▓ #▓  ▓ #▓ #▓  ▓  ▓  ▓  ▓  ▓  ▓  ▓  ▓  ▓  ▓  ▓  ▓  ▓  ▓  ▓  ▓  ▓  ▓  ▓  ▓  ▓  ▓##▓  ▓  ▓  ▓  ▓  ▓  ▓  ▓  ▓  ▓  ▓
     #   ###                                                                                 ##       ##        ### #
  ▓  ▓ #▓  ▓ #▓ #▓  ▓  ▓  ▓  ▓  ▓  ▓  ▓  ▓  ▓  ▓  ▓  ▓  ▓  ▓  ▓  ▓  ▓  ▓  ▓  ▓  ▓  ▓  ▓  ▓  ▓  ▓  ▓  ▓  ▓  ▓  ▓  ▓  ▓
                                                                                            ####        ##          ##
  ▓  ▓  ▓  ▓  ▓  ▓  ▓  ▓  ▓  ▓##▓ #▓# ▓ #▓# ▓##▓  ▓ #▓# ▓##▓  ▓##▓  ▓##▓ #▓##▓##▓ #▓##▓# ▓  ▓  ▓ #▓ #▓  ▓ #▓ #▓  ▓  ▓
 ###                         ###  ###   ###  ####   ###  ###  ###   ###  #######  ######     ####            # ###  ##
 #▓ #▓ #▓  ▓  ▓  ▓  ▓  ▓  ▓  ▓##▓ #▓# ▓ #▓# ▓##▓##▓ #▓# ▓##▓ #▓# ▓  ▓##▓ #▓# ▓  ▓  ▓# ▓  ▓  ▓  ▓ #▓  ▓  ▓ #▓  ▓  ▓  ▓
  ###                  ###   ###  ###   ###  ### ## ###  #####      ###  #####      ##                       ##
  ▓ #▓ #▓  ▓  ▓  ▓  ▓  ▓##▓  ▓##▓ #▓# ▓ #▓# ▓##▓  ▓##▓# ▓##▓ #▓# ▓  ▓##▓ #▓# ▓  ▓  ▓  ▓# ▓  ▓  ▓ #▓  ▓  ▓  ▓ #▓  ▓  ▓
    ##   ###            ########  #########  ###   ####  ###  ###   ###  #######  ######      ##     #   #   ###
  ▓  ▓ #▓  ▓ #▓ #▓  ▓  ▓##▓##▓##▓ #▓##▓##▓# ▓##▓  ▓ #▓# ▓##▓  ▓##▓  ▓##▓ #▓##▓##▓ #▓##▓# ▓  ▓  ▓ #▓ #▓  ▓ #▓ #▓  ▓  ▓
         ###                                                                                      ####             ###
  ▓ #▓ #▓  ▓  ▓ #▓  ▓  ▓  ▓  ▓  ▓  ▓  ▓  ▓  ▓  ▓  ▓  ▓  ▓  ▓  ▓  ▓  ▓  ▓  ▓  ▓  ▓  ▓  ▓  ▓  ▓  ▓  ▓  ▓  ▓  ▓  ▓  ▓  ▓
 #####   # #                             #####             #####                                                #####
  ▓ #▓ #▓  ▓ #▓ #▓  ▓  ▓  ▓  ▓  ▓  ▓ #▓ #▓##▓##▓  ▓  ▓  ▓ #▓##▓##▓  ▓  ▓  ▓  ▓  ▓  ▓##▓  ▓  ▓  ▓  ▓##▓  ▓  ▓  ▓##▓##▓
   ###                   ###                #                                        ###                          ###
  ▓##▓  ▓  ▓  ▓  ▓ #▓  ▓##▓##▓ #▓# ▓##▓##▓ #▓# ▓ #▓# ▓ #▓# ▓##▓# ▓  ▓  ▓  ▓  ▓  ▓  ▓##▓# ▓  ▓  ▓  ▓  ▓ #▓ #▓  ▓  ▓##▓
                       ##  ##          ###                  ##
  ▓##▓##▓# ▓  ▓  ▓ #▓  ▓  ▓# ▓ #▓# ▓##▓##▓ #▓##▓##▓# ▓ #▓# ▓##▓# ▓  ▓  ▓  ▓  ▓  ▓  ▓##▓  ▓  ▓  ▓  ▓  ▓ #▓ #▓  ▓  ▓  ▓
##########               #####   ####         ####           ####           ########
##▓##▓# ▓  ▓  ▓  ▓ #▓  ▓ #▓##▓ #▓# ▓ #▓# ▓ #▓# ▓ #▓# ▓ #▓# ▓ #▓##▓  ▓  ▓  ▓  ▓  ▓##▓##▓  ▓  ▓  ▓  ▓  ▓ #▓ #▓  ▓  ▓##▓##
#######                    ###                                 ###               ####                            ######
  ▓##▓# ▓  ▓  ▓  ▓ #▓  ▓ #▓# ▓ #▓# ▓ #▓# ▓ #▓# ▓ #▓# ▓ #▓# ▓ #▓##▓  ▓  ▓  ▓  ▓  ▓  ▓  ▓  ▓  ▓  ▓  ▓  ▓ #▓ #▓  ▓##▓##▓
~   ###                                                                                                     ######    ~