~
  ▓▓▓###▓▓▓###▓▓▓   ▓▓▓   ▓▓▓   ▓▓▓   ▓▓▓   ▓▓▓###▓▓▓###▓▓▓   ▓▓▓   ▓▓▓   ▓▓▓   ▓▓▓   ▓▓▓   ▓▓▓   ▓▓▓   ▓▓▓###▓▓▓###▓▓
##▓▓▓###▓▓▓###▓▓▓   ▓▓▓   ▓▓▓   ▓▓▓   ▓▓▓   ▓▓▓###▓▓▓###▓▓▓   ▓▓▓   ▓▓▓   ▓▓▓   ▓▓▓   ▓▓▓   ▓▓▓   ▓▓▓   ▓▓▓###▓▓▓###▓▓
###########           ########           ###      #######           ####  ####       #########               ##########
########             ########          ######     #######              ###   ###         ####                ##########
  ▓▓▓   ▓▓▓   ▓▓▓   ▓▓▓   ▓▓▓   ▓▓▓   ▓▓▓   ▓▓▓   ▓▓▓   ▓▓▓   ▓▓▓   ▓▓▓   ▓▓▓   ▓▓▓   ▓▓▓   ▓▓▓   ▓▓▓   ▓▓▓   ▓▓▓###▓▓▓
  ▓▓▓   ▓▓▓   ▓▓▓   ▓▓▓   ▓▓▓   ▓▓▓   ▓▓▓   ▓▓▓   ▓▓▓   ▓▓▓   ▓▓▓   ▓▓▓   ▓▓▓   ▓▓▓   ▓▓▓   ▓▓▓   ▓▓▓   ▓▓▓   ▓▓▓###▓▓▓
              ######                        #########                              ######
              ######                         #######                               ######
  ▓▓▓###▓▓▓   ▓▓▓   ▓▓▓   ▓▓▓   ▓▓▓   ▓▓▓   ▓▓▓   ▓▓▓   ▓▓▓   ▓▓▓   ▓▓▓   ▓▓▓   ▓▓▓###▓▓▓   ▓▓▓   ▓▓▓   ▓▓▓   ▓▓▓   ▓▓▓
  ▓▓▓###▓▓▓   ▓▓▓   ▓▓▓   ▓▓▓   ▓▓▓   ▓▓▓   ▓▓▓   ▓▓▓   ▓▓▓   ▓▓▓   ▓▓▓   ▓▓▓   ▓▓▓###▓▓▓   ▓▓▓   ▓▓▓   ▓▓▓   ▓▓▓   ▓▓▓
     ###                  ▓▓▓                           ▓▓▓                                          #########
     ###                  ▓▓▓                           ▓▓▓                                          #########
  ▓▓▓   ▓▓▓   ▓▓▓   ▓▓▓   ▓▓▓   ▓▓▓   ▓▓▓   ▓▓▓         ▓▓▓   ▓▓▓   ▓▓▓   ▓▓▓▓▓▓▓▓▓   ▓▓▓▓▓▓▓▓▓   ▓▓▓   ▓▓▓###▓▓▓   ▓▓▓
  ▓▓▓   ▓▓▓   ▓▓▓   ▓▓▓   ▓▓▓   ▓▓▓   ▓▓▓   ▓▓▓▓▓▓▓▓▓   ▓▓▓   ▓▓▓         ▓▓▓   ▓▓▓   ▓▓▓         ▓▓▓   ▓▓▓###▓▓▓   ▓▓▓
                 ▓▓▓      ▓▓▓   ▓▓▓   ▓▓▓   ▓▓▓   ▓▓▓   ▓▓▓▓▓▓      ▓▓▓   ▓▓▓▓▓▓         ▓▓▓
                 ▓▓▓      ▓▓▓   ▓▓▓   ▓▓▓   ▓▓▓   ▓▓▓   ▓▓▓   ▓▓▓   ▓▓▓   ▓▓▓               ▓▓▓
  ▓▓▓   ▓▓▓   ▓▓▓   ▓▓▓▓▓▓▓▓▓   ▓▓▓   ▓▓▓   ▓▓▓   ▓▓▓   ▓▓▓   ▓▓▓   ▓▓▓   ▓▓▓   ▓▓▓   ▓▓▓   ▓▓▓   ▓▓▓   ▓▓▓   ▓▓▓   ▓▓▓
  ▓▓▓   ▓▓▓   ▓▓▓   ▓▓▓▓▓▓▓▓▓   ▓▓▓▓▓▓▓▓▓   ▓▓▓   ▓▓▓   ▓▓▓   ▓▓▓   ▓▓▓   ▓▓▓▓▓▓▓▓▓   ▓▓▓▓▓▓▓▓▓   ▓▓▓   ▓▓▓   ▓▓▓   ▓▓▓
    #####                          ###               ###            ###            ###            ######         ######
     ###                           ###               ###            ###            ###            ######         ######
  ▓▓▓###▓▓▓   ▓▓▓   ▓▓▓###▓▓▓   ▓▓▓   ▓▓▓   ▓▓▓   ▓▓▓   ▓▓▓   ▓▓▓   ▓▓▓   ▓▓▓   ▓▓▓   ▓▓▓   ▓▓▓   ▓▓▓   ▓▓▓   ▓▓▓   ▓▓▓
  ▓▓▓###▓▓▓   ▓▓▓   ▓▓▓###▓▓▓   ▓▓▓   ▓▓▓   ▓▓▓   ▓▓▓   ▓▓▓   ▓▓▓   ▓▓▓   ▓▓▓   ▓▓▓   ▓▓▓   ▓▓▓   ▓▓▓   ▓▓▓   ▓▓▓   ▓▓▓
    #####
     ####                          ▓▓▓      ▓▓▓▓▓▓▓▓▓   ▓▓▓   ▓▓▓▓▓▓▓▓▓
   ▓▓   ▓▓▓   ▓▓▓   ▓▓▓   ▓▓▓   ▓▓▓   ▓▓▓   ▓▓▓   ▓▓▓   ▓▓▓         ▓▓▓   ▓▓▓   ▓▓▓   ▓▓▓   ▓▓▓###▓▓▓   ▓▓▓   ▓▓▓   ▓▓▓
   ▓▓   ▓▓▓   ▓▓▓   ▓▓▓   ▓▓▓   ▓▓▓   ▓▓▓   ▓▓▓   ▓▓▓   ▓▓▓         ▓▓▓   ▓▓▓   ▓▓▓   ▓▓▓   ▓▓▓###▓▓▓   ▓▓▓   ▓▓▓   ▓▓▓
              ###                     ▓▓▓   ▓▓▓   ▓▓▓   ▓▓▓   ###   ▓▓▓            ###                  #######
              ###                  ▓▓▓      ▓▓▓   ▓▓▓   ▓▓▓   ###   ▓▓▓           #####                 #######
   ▓▓   ▓▓▓   ▓▓▓   ▓▓▓   ▓▓▓   ▓▓▓         ▓▓▓   ▓▓▓   ▓▓▓   ###   ▓▓▓   ▓▓▓   ▓▓▓   ▓▓▓   ▓▓▓   ▓▓▓   ▓▓▓   ▓▓▓   ▓▓▓
   ▓▓   ▓▓▓   ▓▓▓   ▓▓▓   ▓▓▓   ▓▓▓▓▓▓▓▓▓   ▓▓▓▓▓▓▓▓▓   ▓▓▓         ▓▓▓   ▓▓▓   ▓▓▓   ▓▓▓   ▓▓▓   ▓▓▓   ▓▓▓   ▓▓▓   ▓▓▓


 ##▓▓   ▓▓▓   ▓▓▓   ▓▓▓   ▓▓▓   ▓▓▓   ▓▓▓   ▓▓▓   ▓▓▓   ▓▓▓   ▓▓▓   ▓▓▓   ▓▓▓   ▓▓▓   ▓▓▓   ▓▓▓   ▓▓▓   ▓▓▓   ▓▓▓   ▓▓▓
 ##▓▓   ▓▓▓   ▓▓▓   ▓▓▓   ▓▓▓   ▓▓▓   ▓▓▓   ▓▓▓   ▓▓▓   ▓▓▓   ▓▓▓   ▓▓▓   ▓▓▓   ▓▓▓   ▓▓▓   ▓▓▓   ▓▓▓   ▓▓▓   ▓▓▓###▓▓▓
 #######                     ###               ###               ##########                                ############
 ##########               #########                              ###   ###                  ############      #########
 ##▓▓###▓▓▓###▓▓▓   ▓▓▓   ▓▓▓   ▓▓▓   ▓▓▓   ▓▓▓   ▓▓▓   ▓▓▓   ▓▓▓   ▓▓▓   ▓▓▓   ▓▓▓   ▓▓▓   ▓▓▓   ▓▓▓   ▓▓▓   ▓▓▓###▓▓▓
  #▓▓###▓▓▓###▓▓▓   ▓▓▓   ▓▓▓   ▓▓▓   ▓▓▓   ▓▓▓   ▓▓▓   ▓▓▓   ▓▓▓   ▓▓▓   ▓▓▓   ▓▓▓   ▓▓▓   ▓▓▓   ▓▓▓   ▓▓▓   ▓▓▓###▓▓▓
     #########               ###############           ###################            #############      ###########
