~   ####                                                                                                       ####   ~
  ▓▓▓   ▓▓▓   ▓▓▓   ▓▓▓   ▓▓▓   ▓▓▓   ▓▓▓   ▓▓▓   ▓▓▓   ▓▓▓   ▓▓▓   ▓▓▓   ▓▓▓   ▓▓▓   ▓▓▓   ▓▓▓   ▓▓▓   ▓▓▓   ▓▓▓   ▓▓▓
  ▓▓▓   ▓▓▓   ▓▓▓   ▓▓▓   ▓▓▓   ▓▓▓   ▓▓▓   ▓▓▓   ▓▓▓   ▓▓▓   ▓▓▓   ▓▓▓   ▓▓▓   ▓▓▓   ▓▓▓   ▓▓▓   ▓▓▓   ▓▓▓   ▓▓▓   ▓▓▓


  ▓▓▓   ▓▓▓   ▓▓▓   ▓▓▓   ▓▓▓   ▓▓▓   ▓▓▓   ▓▓▓   ▓▓▓   ▓▓▓   ▓▓▓   ▓▓▓   ▓▓▓   ▓▓▓   ▓▓▓   ▓▓▓   ▓▓▓   ▓▓▓   ▓▓▓   ▓▓▓
  ▓▓▓   ▓▓▓   ▓▓▓   ▓▓▓   ▓▓▓   ▓▓▓   ▓▓▓   ▓▓▓   ▓▓▓   ▓▓▓   ▓▓▓   ▓▓▓   ▓▓▓   ▓▓▓   ▓▓▓   ▓▓▓   ▓▓▓   ▓▓▓   ▓▓▓   ▓▓▓


  ▓▓▓   ▓▓▓   ▓▓▓   ▓▓▓   ▓▓▓   ▓▓▓   ▓▓▓   ▓▓▓   ▓▓▓   ▓▓▓   ▓▓▓   ▓▓▓   ▓▓▓   ▓▓▓   ▓▓▓   ▓▓▓   ▓▓▓   ▓▓▓   ▓▓▓   ▓▓▓
  ▓▓▓   ▓▓▓   ▓▓▓   ▓▓▓   ▓▓▓   ▓▓▓   ▓▓▓   ▓▓▓   ▓▓▓   ▓▓▓   ▓▓▓   ▓▓▓   ▓▓▓   ▓▓▓   ▓▓▓   ▓▓▓   ▓▓▓   ▓▓▓   ▓▓▓   ▓▓▓


  ▓▓▓   ▓▓▓   ▓▓▓   ▓▓▓   ▓▓▓   ▓▓▓   ▓▓▓   ▓▓▓   ▓▓▓   ▓▓▓   ▓▓▓   ▓▓▓   ▓▓▓   ▓▓▓   ▓▓▓   ▓▓▓   ▓▓▓   ▓▓▓   ▓▓▓   ▓▓▓
  ▓▓▓   ▓▓▓   ▓▓▓   ▓▓▓   ▓▓▓   ▓▓▓   ▓▓▓   ▓▓▓   ▓▓▓   ▓▓▓   ▓▓▓   ▓▓▓   ▓▓▓   ▓▓▓   ▓▓▓   ▓▓▓   ▓▓▓   ▓▓▓   ▓▓▓   ▓▓▓


  ▓▓▓   ▓▓▓   ▓▓▓   ▓▓▓   ▓▓▓   ▓▓▓   ▓▓▓   ▓▓▓   ▓▓▓   ▓▓▓   ▓▓▓   ▓▓▓   ▓▓▓   ▓▓▓   ▓▓▓   ▓▓▓   ▓▓▓   ▓▓▓   ▓▓▓   ▓▓▓
  ▓▓▓   ▓▓▓   ▓▓▓   ▓▓▓   ▓▓▓   ▓▓▓   ▓▓▓   ▓▓▓   ▓▓▓   ▓▓▓   ▓▓▓   ▓▓▓   ▓▓▓   ▓▓▓   ▓▓▓   ▓▓▓   ▓▓▓   ▓▓▓   ▓▓▓   ▓▓▓


  ▓▓▓   ▓▓▓   ▓▓▓   ▓▓▓   ▓▓▓   ▓▓▓   ▓▓▓   ▓▓▓   ▓▓▓   ▓▓▓   ▓▓▓   ▓▓▓   ▓▓▓   ▓▓▓   ▓▓▓   ▓▓▓   ▓▓▓   ▓▓▓   ▓▓▓   ▓▓▓
  ▓▓▓   ▓▓▓   ▓▓▓   ▓▓▓   ▓▓▓   ▓▓▓   ▓▓▓   ▓▓▓   ▓▓▓   ▓▓▓   ▓▓▓   ▓▓▓   ▓▓▓   ▓▓▓   ▓▓▓   ▓▓▓   ▓▓▓   ▓▓▓   ▓▓▓   ▓▓▓


  ▓▓▓   ▓▓▓   ▓▓▓   ▓▓▓   ▓▓▓   ▓▓▓   ▓▓▓   ▓▓▓   ▓▓▓   ▓▓▓   ▓▓▓   ▓▓▓   ▓▓▓   ▓▓▓   ▓▓▓   ▓▓▓   ▓▓▓   ▓▓▓   ▓▓▓   ▓▓▓
  ▓▓▓   ▓▓▓   ▓▓▓   ▓▓▓   ▓▓▓   ▓▓▓   ▓▓▓   ▓▓▓   ▓▓▓   ▓▓▓   ▓▓▓   ▓▓▓   ▓▓▓   ▓▓▓   ▓▓▓   ▓▓▓   ▓▓▓   ▓▓▓   ▓▓▓   ▓▓▓


  ▓▓▓   ▓▓▓   ▓▓▓   ▓▓▓   ▓▓▓   ▓▓▓   ▓▓▓   ▓▓▓   ▓▓▓   ▓▓▓   ▓▓▓   ▓▓▓   ▓▓▓   ▓▓▓   ▓▓▓   ▓▓▓   ▓▓▓   ▓▓▓   ▓▓▓   ▓▓▓
  ▓▓▓   ▓▓▓   ▓▓▓   ▓▓▓   ▓▓▓   ▓▓▓   ▓▓▓   ▓▓▓   ▓▓▓   ▓▓▓   ▓▓▓   ▓▓▓   ▓▓▓   ▓▓▓   ▓▓▓   ▓▓▓   ▓▓▓   ▓▓▓   ▓▓▓   ▓▓▓


  ▓▓▓   ▓▓▓   ▓▓▓   ▓▓▓   ▓▓▓   ▓▓▓   ▓▓▓   ▓▓▓   ▓▓▓   ▓▓▓   ▓▓▓   ▓▓▓   ▓▓▓   ▓▓▓   ▓▓▓   ▓▓▓   ▓▓▓   ▓▓▓   ▓▓▓   ▓▓▓
  ▓▓▓   ▓▓▓   ▓▓▓   ▓▓▓   ▓▓▓   ▓▓▓   ▓▓▓   ▓▓▓   ▓▓▓   ▓▓▓   ▓▓▓   ▓▓▓   ▓▓▓   ▓▓▓   ▓▓▓   ▓▓▓   ▓▓▓   ▓▓▓   ▓▓▓   ▓▓▓


  ▓▓▓   ▓▓▓   ▓▓▓   ▓▓▓   ▓▓▓   ▓▓▓   ▓▓▓   ▓▓▓   ▓▓▓   ▓▓▓   ▓▓▓   ▓▓▓   ▓▓▓   ▓▓▓   ▓▓▓   ▓▓▓   ▓▓▓   ▓▓▓   ▓▓▓   ▓▓▓
  ▓▓▓   ▓▓▓   ▓▓▓   ▓▓▓   ▓▓▓   ▓▓▓   ▓▓▓   ▓▓▓   ▓▓▓   ▓▓▓   ▓▓▓   ▓▓▓   ▓▓▓   ▓▓▓   ▓▓▓   ▓▓▓   ▓▓▓   ▓▓▓   ▓▓▓   ▓▓▓

~                                                                                                                     ~