 ~ ~ ~#~#~#~ ~ ~ ~ ~ ~ ~ ~ ~ ~ ~ ~ ~ ~ ~ ~ ~ ~ ~ ~ ~ ~ ~ ~ ~ ~ ~ ~ ~ ~ ~ ~ ~ ~ ~ ~ ~ ~ ~ ~ ~ ~ ~ ~ ~ ~ ~ ~ ~ ~ ~ ~ ~ ~ ~ ~ ~ ~ ~ ~ ~ ~ ~ ~ ~ ~ ~ ~ ~ ~ ~ ~ ~ ~ ~ ~ ~ ~ ~ ~ ~ ~ ~ ~ ~ ~ ~ ~ ~ ~ ~ ~ ~ ~ ~ ~ ~ ~#~ ~#~ ~ ~ ~ ~ ~ ~#~#~#~#~ ~ ~ ~
 ~ ~▓~#~▓~#~▓~ ~▓~ ~▓~#~▓~ ~▓~ ~▓~ ~▓~#~▓~ ~▓~#~▓~#~▓~#~▓~#~▓~#~▓~#~▓~#~▓~#~▓~#~▓~#~▓~#~▓~#~▓~#~▓~#~▓~#~▓~#~▓~#~▓~#~▓~#~▓~#~▓~#~▓~ ~▓~ ~▓~ ~▓~ ~▓~ ~▓~ ~▓~ ~▓~ ~▓~ ~▓~ ~▓~ ~▓~ ~▓~ ~▓~ ~▓~ ~▓~ ~▓~ ~▓~ ~▓~ ~▓~#~▓~#~▓~ ~▓~ ~▓~ ~▓~#~▓~#~▓~ ~ ~
 ~#~#~#~ ~ ~ ~ ~ ~#~ ~#~ ~ ~ ~ ~ ~ ~ ~ ~ ~#~ ~ ~#~ ~#~ ~#~ ~#~ ~#~ ~#~ ~#~ ~#~ ~#~ ~#~ ~#~ ~#~ ~#~ ~#~ ~#~ ~#~ ~#~ ~#~ ~#~ ~#~ ~ ~ ~ ~ ~ ~ ~ ~ ~ ~ ~ ~ ~ ~ ~ ~#~#~#~#~ ~ ~ ~ ~ ~ ~ ~ ~ ~ ~ ~ ~ ~ ~ ~ ~ ~ ~ ~ ~ ~#~#~ ~ ~ ~ ~ ~ ~ ~#~#~#~#~#~ ~
 ~ ~▓~#~▓~ ~▓~ ~▓~#~▓~ ~▓~ ~▓~ ~▓~ ~▓~ ~▓~ ~▓~ ~▓~ ~▓~ ~▓~ ~▓~ ~▓~ ~▓~ ~▓~ ~▓~ ~▓~ ~▓~ ~▓~ ~▓~ ~▓~ ~▓~ ~▓~ ~▓~ ~▓~ ~▓~ ~▓~ ~▓~ ~▓~ ~▓~ ~▓~ ~▓~ ~▓~ ~▓~ ~▓~ ~▓~#~▓~ ~▓~ ~▓~ ~▓~ ~▓~ ~▓~ ~▓~ ~▓~ ~▓~ ~▓~ ~▓~ ~▓~ ~▓~#~▓~ ~▓~ ~▓~ ~▓~#~▓~#~▓~#~ ~
 ~#~ ~ ~ ~ ~ ~ ~ ~ ~ ~ ~ ~ ~ ~ ~ ~ ~ ~ ~ ~ ~ ~ ~ ~ ~ ~ ~ ~ ~ ~ ~ ~ ~ ~ ~ ~ ~ ~ ~ ~ ~ ~ ~ ~ ~ ~ ~ ~ ~ ~ ~ ~ ~ ~ ~ ~ ~ ~ ~ ~ ~ ~ ~ ~ ~ ~ ~ ~ ~ ~ ~ ~ ~ ~ ~ ~ ~ ~#~ ~ ~ ~#~#~#~#~#~#~#~ ~ ~ ~ ~ ~ ~ ~ ~ ~ ~ ~ ~ ~ ~#~#~ ~ ~ ~ ~ ~ ~ ~#~#~#~ ~ ~ ~
 ~ ~▓~ ~▓~#~▓~ ~▓~ ~▓~#~▓~#~▓~ ~▓~ ~▓~ ~▓~ ~▓~ ~▓~ ~▓~ ~▓~ ~▓~ ~▓~ ~▓~ ~▓~ ~▓~ ~▓~ ~▓~ ~▓~ ~▓~ ~▓~ ~▓~ ~▓~ ~▓~ ~▓~ ~▓~ ~▓~ ~▓~ ~▓~ ~▓~ ~▓~ ~▓~ ~▓~ ~▓~ ~▓~ ~▓~#~▓~ ~▓~#~▓~#~▓~#~▓~#~▓~ ~▓~ ~▓~ ~▓~ ~▓~ ~▓~ ~▓~ ~▓~#~▓~ ~▓~ ~▓~ ~▓~ ~▓~#~▓~ ~ ~
 ~ ~ ~ ~ ~#~ ~#~ ~ ~ ~#~ ~#~ ~ ~ ~ ~ ~ ~ ~ ~ ~ ~ ~ ~ ~ ~ ~ ~ ~ ~ ~ ~ ~ ~ ~ ~ ~ ~ ~ ~ ~ ~ ~ ~ ~ ~ ~ ~ ~ ~ ~ ~ ~ ~ ~ ~ ~ ~ ~ ~ ~ ~ ~ ~ ~ ~ ~ ~ ~ ~ ~ ~ ~ ~ ~ ~ ~ ~ ~ ~ ~ ~ ~#~#~#~ ~ ~ ~ ~ ~ ~ ~ ~ ~ ~ ~ ~ ~ ~ ~#~#~ ~ ~ ~ ~#~#~#~ ~ ~ ~ ~ ~ ~ ~
 ~ ~▓~#~▓~#~▓~#~▓~ ~▓~ ~▓~#~▓~#~▓~ ~▓~ ~▓~#~▓~ ~▓~#~▓~ ~▓~ ~▓~#~▓~ ~▓~#~▓~#~▓~#~▓~ ~▓~#~▓~#~▓~ ~▓~#~▓~ ~▓~ ~▓~#~▓~ ~▓~ ~▓~#~▓~ ~▓~ ~▓~ ~▓~ ~▓~ ~▓~ ~▓~ ~▓~ ~▓~ ~▓~ ~▓~ ~▓~#~▓~#~▓~ ~▓~ ~▓~ ~▓~ ~▓~ ~▓~ ~▓~ ~▓~#~▓~#~▓~ ~▓~#~▓~#~▓~ ~▓~ ~▓~ ~ ~
 ~ ~ ~ ~ ~ ~ ~ ~ ~ ~ ~ ~ ~#~ ~#~ ~ ~ ~ ~ ~#~ ~ ~ ~#~#~ ~ ~ ~ ~#~ ~ ~ ~ ~ ~#~ ~ ~ ~ ~ ~#~ ~ ~ ~ ~ ~#~ ~ ~ ~ ~ ~#~ ~ ~ ~ ~ ~#~ ~ ~ ~ ~ ~ ~ ~ ~ ~ ~ ~ ~ ~ ~ ~ ~ ~ ~ ~ ~ ~ ~ ~#~#~#~ ~ ~ ~ ~ ~ ~ ~ ~ ~ ~ ~ ~ ~ ~ ~ ~ ~ ~ ~ ~ ~ ~ ~#~#~ ~#~#~ ~ ~ ~
 ~ ~▓~ ~▓~ ~▓~ ~▓~ ~▓~ ~▓~#~▓~ ~▓~ ~▓~ ~▓~#~▓~ ~▓~#~▓~#~▓~ ~▓~#~▓~ ~▓~ ~▓~#~▓~ ~▓~ ~▓~#~▓~ ~▓~ ~▓~#~▓~ ~▓~ ~▓~#~▓~ ~▓~ ~▓~#~▓~ ~▓~ ~▓~ ~▓~ ~▓~ ~▓~ ~▓~ ~▓~ ~▓~ ~▓~ ~▓~ ~▓~#~▓~#~▓~ ~▓~ ~▓~ ~▓~ ~▓~ ~▓~ ~▓~ ~▓~ ~▓~#~▓~ ~▓~ ~▓~ ~▓~ ~▓~#~▓~ ~ ~
 ~ ~ ~ ~ ~ ~ ~ ~ ~ ~ ~ ~ ~#~ ~ ~ ~ ~ ~ ~ ~#~ ~ ~ ~#~ ~ ~#~ ~ ~#~ ~ ~ ~ ~ ~#~ ~ ~ ~ ~ ~#~ ~#~ ~ ~ ~#~ ~ ~ ~ ~ ~#~ ~ ~ ~ ~ ~#~ ~ ~ ~ ~ ~ ~ ~ ~ ~ ~ ~ ~ ~ ~ ~ ~ ~ ~ ~ ~ ~ ~ ~#~#~#~ ~ ~ ~ ~ ~ ~ ~ ~ ~ ~ ~ ~ ~ ~ ~ ~#~#~ ~ ~ ~ ~#~#~ ~ ~ ~#~#~#~ ~
 ~ ~▓~ ~▓~ ~▓~ ~▓~ ~▓~ ~▓~ ~▓~ ~▓~ ~▓~ ~▓~#~▓~ ~▓~#~▓~ ~▓~#~▓~#~▓~ ~▓~ ~▓~#~▓~ ~▓~ ~▓~#~▓~ ~▓~ ~▓~#~▓~ ~▓~ ~▓~#~▓~ ~▓~ ~▓~#~▓~ ~▓~ ~▓~ ~▓~ ~▓~ ~▓~ ~▓~ ~▓~ ~▓~ ~▓~ ~▓~ ~▓~#~▓~#~▓~ ~▓~ ~▓~ ~▓~ ~▓~ ~▓~ ~▓~ ~▓~#~▓~ ~▓~ ~▓~#~▓~#~▓~ ~▓~#~▓~#~ ~
 ~ ~ ~ ~ ~ ~ ~ ~ ~#~#~#~ ~#~ ~ ~ ~ ~ ~ ~ ~#~ ~ ~ ~#~ ~ ~ ~ ~#~#~ ~ ~ ~ ~ ~#~ ~ ~ ~ ~ ~#~ ~ ~ ~ ~ ~#~ ~ ~ ~ ~ ~#~ ~ ~ ~ ~ ~#~ ~ ~ ~ ~ ~ ~ ~ ~ ~ ~ ~ ~ ~ ~ ~ ~ ~ ~ ~ ~ ~ ~ ~#~#~#~ ~ ~ ~ ~ ~ ~ ~ ~ ~ ~ ~ ~ ~ ~ ~#~#~ ~ ~ ~#~#~#~#~ ~ ~ ~#~#~#~ ~
 ~ ~▓~ ~▓~ ~▓~ ~▓~#~▓~#~▓~ ~▓~ ~▓~ ~▓~ ~▓~#~▓~ ~▓~#~▓~ ~▓~ ~▓~#~▓~ ~▓~ ~▓~#~▓~ ~▓~ ~▓~#~▓~#~▓~ ~▓~#~▓~#~▓~ ~▓~#~▓~#~▓~ ~▓~#~▓~ ~▓~ ~▓~ ~▓~ ~▓~ ~▓~ ~▓~ ~▓~ ~▓~ ~▓~ ~▓~#~▓~#~▓~#~▓~#~▓~ ~▓~ ~▓~ ~▓~ ~▓~ ~▓~ ~▓~#~▓~ ~▓~#~▓~#~▓~ ~▓~ ~▓~ ~▓~ ~ ~
 ~ ~ ~ ~ ~ ~ ~ ~ ~ ~ ~ ~ ~ ~ ~ ~ ~ ~ ~ ~ ~ ~ ~ ~ ~ ~ ~ ~ ~ ~ ~ ~ ~ ~ ~ ~ ~ ~ ~ ~ ~ ~ ~ ~ ~ ~ ~ ~ ~ ~ ~ ~ ~ ~ ~ ~ ~ ~ ~ ~ ~ ~ ~ ~ ~ ~ ~ ~ ~ ~ ~ ~ ~ ~ ~ ~ ~ ~ ~ ~ ~ ~ ~#~#~#~#~#~#~#~ ~ ~ ~#~#~#~ ~ ~ ~ ~ ~ ~ ~ ~ ~ ~ ~#~#~#~#~#~ ~ ~ ~ ~ ~ ~ ~
 ~ ~▓~ ~▓~#~▓~ ~▓~#~▓~#~▓~ ~▓~ ~▓~ ~▓~ ~▓~ ~▓~ ~▓~ ~▓~ ~▓~ ~▓~ ~▓~ ~▓~ ~▓~ ~▓~ ~▓~ ~▓~ ~▓~ ~▓~ ~▓~ ~▓~ ~▓~ ~▓~ ~▓~ ~▓~ ~▓~ ~▓~ ~▓~ ~▓~ ~▓~ ~▓~ ~▓~ ~▓~ ~▓~ ~▓~ ~▓~ ~▓~ ~▓~ ~▓~ ~▓~ ~▓~ ~▓~#~▓~#~▓~ ~▓~ ~▓~ ~▓~ ~▓~ ~▓~ ~▓~#~▓~ ~▓~#~▓~#~▓~#~ ~
 ~ ~ ~ ~ ~#~ ~ ~ ~#~#~#~ ~ ~ ~ ~ ~ ~ ~ ~ ~ ~ ~ ~ ~ ~ ~ ~ ~ ~ ~ ~ ~ ~ ~ ~ ~ ~ ~ ~ ~ ~ ~ ~ ~ ~ ~ ~ ~ ~ ~ ~ ~ ~ ~ ~ ~ ~ ~ ~ ~ ~ ~ ~ ~ ~ ~ ~ ~ ~ ~ ~ ~ ~ ~ ~ ~ ~ ~ ~ ~ ~ ~ ~ ~ ~ ~ ~ ~ ~ ~ ~ ~#~#~#~ ~ ~ ~ ~ ~ ~ ~#~#~ ~ ~ ~ ~ ~ ~ ~ ~#~#~#~ ~#~ ~
 ~ ~▓~ ~▓~#~▓~ ~▓~#~▓~#~▓~ ~▓~ ~▓~ ~▓~ ~▓~ ~▓~ ~▓~ ~▓~ ~▓~ ~▓~ ~▓~ ~▓~ ~▓~ ~▓~ ~▓~ ~▓~ ~▓~ ~▓~ ~▓~ ~▓~ ~▓~ ~▓~ ~▓~ ~▓~ ~▓~ ~▓~ ~▓~ ~▓~ ~▓~ ~▓~ ~▓~ ~▓~ ~▓~ ~▓~ ~▓~ ~▓~ ~▓~ ~▓~ ~▓~ ~▓~ ~▓~#~▓~#~▓~ ~▓~ ~▓~ ~▓~ ~▓~#~▓~ ~▓~ ~▓~ ~▓~ ~▓~#~▓~#~ ~
 ~ ~ ~ ~ ~ ~ ~ ~ ~ ~ ~ ~ ~ ~ ~ ~ ~ ~ ~ ~ ~ ~ ~ ~ ~ ~ ~ ~ ~ ~ ~ ~ ~ ~ ~ ~ ~ ~ ~ ~ ~ ~ ~ ~ ~ ~ ~ ~ ~ ~ ~ ~ ~ ~ ~ ~ ~ ~ ~ ~ ~ ~ ~ ~ ~ ~ ~ ~ ~ ~ ~ ~ ~ ~ ~ ~ ~ ~ ~ ~ ~ ~ ~ ~ ~ ~ ~ ~ ~ ~ ~ ~ ~#~#~#~ ~ ~ ~ ~ ~ ~ ~ ~#~#~ ~ ~ ~ ~ ~ ~ ~ ~ ~ ~#~#~ ~
 ~ ~▓~ ~▓~ ~▓~ ~▓~ ~▓~ ~▓~ ~▓~ ~▓~ ~▓~ ~▓~ ~▓~ ~▓~ ~▓~ ~▓~ ~▓~#~▓~ ~▓~#~▓~ ~▓~#~▓~ ~▓~#~▓~ ~▓~ ~▓~#~▓~ ~▓~#~▓~ ~▓~#~▓~ ~▓~#~▓~ ~▓~#~▓~#~▓~ ~▓~#~▓~#~▓~ ~▓~ ~▓~ ~▓~ ~▓~ ~▓~ ~▓~ ~▓~ ~▓~ ~▓~#~▓~#~▓~ ~▓~ ~▓~ ~▓~ ~▓~ ~▓~ ~▓~ ~▓~ ~▓~#~▓~ ~▓~#~ ~
 ~#~#~#~ ~ ~ ~ ~ ~ ~ ~ ~ ~ ~ ~ ~ ~ ~ ~ ~ ~ ~ ~ ~ ~ ~ ~ ~ ~ ~ ~#~ ~ ~ ~#~ ~ ~ ~#~ ~ ~ ~#~#~ ~ ~ ~ ~#~ ~ ~ ~#~ ~ ~#~ ~ ~ ~ ~#~ ~ ~ ~#~ ~ ~ ~ ~ ~#~ ~#~ ~ ~ ~ ~ ~ ~ ~ ~ ~ ~ ~ ~ ~ ~#~#~#~ ~ ~#~#~#~ ~ ~ ~ ~ ~ ~ ~ ~ ~ ~ ~ ~ ~#~ ~#~#~#~ ~ ~#~#~ ~
 ~#~▓~#~▓~#~▓~ ~▓~ ~▓~ ~▓~ ~▓~ ~▓~ ~▓~ ~▓~ ~▓~ ~▓~ ~▓~ ~▓~ ~▓~#~▓~ ~▓~#~▓~ ~▓~#~▓~ ~▓~#~▓~#~▓~ ~▓~#~▓~ ~▓~#~▓~#~▓~ ~▓~ ~▓~#~▓~ ~▓~#~▓~ ~▓~ ~▓~#~▓~ ~▓~ ~▓~ ~▓~ ~▓~ ~▓~ ~▓~ ~▓~ ~▓~#~▓~ ~▓~#~▓~#~▓~ ~▓~ ~▓~ ~▓~ ~▓~ ~▓~ ~▓~#~▓~#~▓~ ~▓~ ~▓~ ~ ~
 ~ ~#~#~#~ ~ ~ ~ ~ ~ ~ ~ ~ ~ ~ ~ ~ ~ ~ ~ ~ ~ ~ ~ ~ ~ ~ ~ ~ ~ ~#~ ~ ~ ~#~ ~ ~ ~#~ ~ ~ ~#~ ~ ~#~ ~ ~#~ ~ ~ ~#~#~ ~ ~ ~ ~ ~ ~#~ ~ ~ ~#~#~#~ ~ ~ ~ ~#~ ~ ~ ~ ~ ~ ~ ~ ~ ~ ~ ~ ~ ~ ~ ~#~#~#~ ~ ~#~#~#~ ~ ~ ~ ~ ~ ~ ~ ~ ~ ~ ~ ~ ~#~#~ ~ ~ ~ ~ ~ ~ ~ ~
 ~ ~▓~#~▓~#~▓~ ~▓~ ~▓~ ~▓~ ~▓~ ~▓~ ~▓~ ~▓~ ~▓~ ~▓~ ~▓~#~▓~ ~▓~#~▓~ ~▓~#~▓~ ~▓~#~▓~ ~▓~#~▓~ ~▓~#~▓~#~▓~ ~▓~#~▓~#~▓~ ~▓~ ~▓~#~▓~ ~▓~#~▓~ ~▓~ ~▓~ ~▓~#~▓~ ~▓~ ~▓~ ~▓~ ~▓~ ~▓~ ~▓~ ~▓~#~▓~ ~▓~#~▓~#~▓~ ~▓~ ~▓~#~▓~ ~▓~#~▓~ ~▓~#~▓~ ~▓~ ~▓~ ~▓~ ~ ~
 ~ ~ ~ ~#~#~ ~ ~ ~#~#~#~ ~ ~ ~ ~ ~ ~ ~ ~ ~ ~ ~ ~ ~ ~ ~#~ ~ ~ ~#~ ~ ~ ~#~ ~ ~ ~#~ ~ ~ ~#~ ~ ~ ~ ~#~#~ ~ ~ ~#~ ~ ~#~ ~ ~ ~ ~#~ ~ ~ ~#~ ~ ~ ~ ~ ~#~ ~#~ ~ ~ ~ ~ ~ ~ ~ ~ ~ ~ ~ ~ ~ ~ ~#~#~#~#~#~#~#~ ~ ~ ~ ~ ~#~ ~ ~ ~#~ ~ ~ ~#~#~#~ ~ ~ ~ ~ ~ ~ ~
 ~ ~▓~ ~▓~#~▓~ ~▓~#~▓~#~▓~ ~▓~ ~▓~ ~▓~ ~▓~ ~▓~ ~▓~ ~▓~#~▓~#~▓~#~▓~ ~▓~#~▓~#~▓~#~▓~ ~▓~#~▓~ ~▓~ ~▓~#~▓~ ~▓~#~▓~ ~▓~#~▓~ ~▓~#~▓~ ~▓~#~▓~#~▓~ ~▓~#~▓~#~▓~ ~▓~ ~▓~ ~▓~ ~▓~ ~▓~ ~▓~ ~▓~ ~▓~ ~▓~ ~▓~ ~▓~ ~▓~ ~▓~#~▓~ ~▓~#~▓~ ~▓~ ~▓~#~▓~ ~▓~ ~▓~ ~ ~
 ~ ~ ~ ~ ~ ~ ~ ~ ~#~#~#~ ~ ~ ~ ~ ~ ~ ~ ~ ~ ~ ~ ~ ~ ~ ~ ~ ~ ~ ~ ~ ~ ~ ~ ~ ~ ~ ~ ~ ~ ~ ~ ~ ~ ~ ~ ~ ~ ~ ~ ~ ~ ~ ~ ~ ~ ~ ~ ~ ~ ~ ~ ~ ~ ~ ~ ~ ~ ~ ~ ~ ~ ~ ~ ~ ~ ~ ~ ~ ~ ~ ~ ~ ~ ~ ~ ~ ~ ~ ~ ~ ~ ~ ~ ~ ~ ~#~#~#~#~ ~ ~ ~ ~ ~ ~ ~ ~ ~ ~ ~ ~ ~#~#~#~ ~
 ~ ~▓~#~▓~#~▓~ ~▓~ ~▓~#~▓~ ~▓~ ~▓~ ~▓~ ~▓~ ~▓~ ~▓~ ~▓~ ~▓~ ~▓~ ~▓~ ~▓~ ~▓~ ~▓~ ~▓~ ~▓~ ~▓~ ~▓~ ~▓~ ~▓~ ~▓~ ~▓~ ~▓~ ~▓~ ~▓~ ~▓~ ~▓~ ~▓~ ~▓~ ~▓~ ~▓~ ~▓~ ~▓~ ~▓~ ~▓~ ~▓~ ~▓~ ~▓~ ~▓~ ~▓~ ~▓~ ~▓~ ~▓~ ~▓~ ~▓~ ~▓~ ~▓~ ~▓~ ~▓~ ~▓~ ~▓~#~▓~#~▓~#~ ~
 ~#~#~#~#~#~ ~ ~ ~#~ ~#~ ~ ~ ~ ~ ~ ~ ~ ~ ~ ~ ~ ~ ~ ~#~ ~#~ ~#~ ~#~ ~#~ ~#~ ~#~ ~#~ ~#~ ~#~ ~#~ ~#~ ~#~ ~#~ ~#~ ~#~ ~#~ ~#~ ~#~ ~#~ ~#~ ~#~ ~#~ ~#~ ~#~ ~ ~ ~ ~ ~ ~ ~ ~ ~ ~ ~ ~ ~ ~ ~ ~ ~ ~ ~ ~ ~ ~ ~ ~ ~ ~ ~ ~ ~ ~ ~ ~ ~ ~ ~ ~ ~ ~#~#~#~#~#~ ~
 ~ ~▓~#~▓~#~▓~ ~▓~#~▓~#~▓~ ~▓~ ~▓~ ~▓~ ~▓~ ~▓~ ~▓~#~▓~#~▓~#~▓~#~▓~#~▓~#~▓~#~▓~#~▓~#~▓~#~▓~#~▓~#~▓~#~▓~#~▓~#~▓~#~▓~#~▓~#~▓~#~▓~#~▓~#~▓~#~▓~#~▓~#~▓~#~▓~#~▓~ ~▓~ ~▓~ ~▓~ ~▓~ ~▓~ ~▓~ ~▓~ ~▓~ ~▓~ ~▓~ ~▓~ ~▓~ ~▓~ ~▓~ ~▓~ ~▓~ ~▓~ ~▓~#~▓~#~▓~ ~ ~
 ~ ~ ~#~#~#~ ~ ~ ~ ~ ~ ~ ~ ~ ~ ~ ~ ~ ~ ~ ~ ~ ~ ~ ~ ~ ~ ~ ~ ~ ~ ~ ~ ~ ~ ~ ~ ~ ~ ~ ~ ~ ~ ~ ~ ~ ~ ~ ~ ~ ~ ~ ~ ~ ~ ~ ~ ~ ~ ~ ~ ~ ~ ~ ~ ~ ~ ~ ~ ~ ~ ~ ~ ~ ~ ~ ~ ~ ~ ~ ~ ~ ~ ~ ~ ~ ~ ~ ~ ~ ~ ~ ~ ~ ~ ~ ~ ~ ~ ~ ~ ~ ~ ~ ~ ~ ~ ~ ~ ~ ~ ~ ~ ~#~#~ ~ ~ ~