~                                                         ~
      ░░░░░░░░░░▓▓▓░░░░░░░░░░░░░░░▓▓▓░░░░░░░░░░░░░░░░
    ▓▓▓░░░▓▓▓░░░▓▓▓░░░▓▓▓░░░▓▓▓░░░▓▓▓░░░▓▓▓░░░▓▓▓░░░▓▓▓
 ░░░░░░░░░░░░░░░░░░░░░░░░░░░░░░░░░░░░░░░░░░░░░░░░░░░░░░░░░
 ░░░▓▓▓░░░▓▓▓░░░▓▓▓░░░▓▓▓░░░▓▓▓░░░▓▓▓░░░▓▓▓░░░▓▓▓░░░▓▓▓░░░
 ░░░░░░░░░░░░░░░░░░   ░░░░░░░░░░░░░░░░░░░░░░░░░░░░░░░░░░░░
 ▓▓▓▓▓▓░░░▓▓▓░░░▓▓▓   ▓▓▓░░░▓▓▓░░░▓▓▓░░░▓▓▓░░░▓▓▓░░░▓▓▓▓▓▓
 ░░░░░░░░░░░░░░░░░░   ░░░░░░░░░░░░░░░░░░░░░░░░░░░░░░░░░░░░
 ░░░▓▓▓░░░▓▓▓░░░▓▓▓   ▓▓▓░░░▓▓▓░░░▓▓▓░░░▓▓▓░░░▓▓▓░░░▓▓▓░░░
 ░░░░░░░░░░░░░░░░░░   ░░░░░░░░░░░░░░░░░░░░░░░░░░░░░░░░░░░░
 ░░░▓▓▓░░░▓▓▓░░░▓▓▓   ▓▓▓░░░▓▓▓░░░▓▓▓   ▓▓▓░░░▓▓▓░░░▓▓▓░░░
 ░░░░░░░░░░░░░░░░░░░░░░░░░░░░░░░░░░░░   ░░░░░░░░░░░░░░░░░░
 ░░░▓▓▓░░░▓▓▓░░░▓▓▓░░░▓▓▓░░░▓▓▓░░░▓▓▓   ▓▓▓░░░▓▓▓░░░▓▓▓░░░
 ░░░░░░░░░░░░░░░░░░░░░░░░░░░░░░░░░░░░   ░░░░░░░░░░░░░░░░░░
 ▓▓▓▓▓▓░░░▓▓▓░░░▓▓▓░░░▓▓▓░░░▓▓▓   ▓▓▓   ▓▓▓░░░▓▓▓░░░▓▓▓▓▓▓
 ░░░░░░░░░░░░░░░░░░░░░░░░░░░░░░         ░░░░░░░░░░░░░░░░░░
 ░░░▓▓▓░░░▓▓▓░░░▓▓▓░░░▓▓▓░░░▓▓▓░░░▓▓▓░░░▓▓▓░░░▓▓▓░░░▓▓▓░░░
 ░░░░░░░░░░░░░░░░░░░░░░░░░░░░░░░░░░░░░░░░░░░░░░░░░░░░░░░░░
    ▓▓▓░░░▓▓▓░░░▓▓▓░░░▓▓▓░░░▓▓▓░░░▓▓▓░░░▓▓▓░░░▓▓▓░░░▓▓▓
      ░░░░░░░░░░▓▓▓░░░░░░░░░░░░░░░▓▓▓░░░░░░░░░░░░░░░░
~                                                         ~