 ~ ~ ~#~#~#~ ~ ~ ~ ~ ~ ~ ~ ~ ~ ~ ~ ~ ~ ~ ~ ~ ~ ~ ~ ~ ~ ~ ~ ~ ~ ~ ~ ~ ~ ~ ~ ~ ~ ~ ~ ~ ~ ~ ~ ~ ~ ~ ~ ~ ~ ~ ~ ~ ~ ~ ~ ~ ~ ~ ~ ~ ~ ~ ~ ~ ~ ~ ~ ~ ~ ~ ~ ~ ~ ~ ~ ~ ~ ~ ~ ~ ~ ~ ~ ~ ~ ~ ~ ~ ~ ~ ~ ~ ~ ~ ~ ~ ~ ~ ~ ~ ~ ~ ~ ~ ~ ~ ~ ~ ~ ~ ~ ~ ~ ~ ~ ~ ~
 ~ ~▓~#~▓~#~▓~ ~▓~ ~▓~ ~▓~ ~▓~ ~▓~ ~▓~ ~▓~ ~▓~ ~▓~ ~▓~ ~▓~ ~▓~ ~▓~ ~▓~ ~▓~ ~▓~ ~▓~ ~▓~ ~▓~ ~▓~ ~▓~ ~▓~ ~▓~ ~▓~ ~▓~ ~▓~ ~▓~ ~▓~ ~▓~ ~▓~ ~▓~ ~▓~ ~▓~ ~▓~ ~▓~ ~▓~ ~▓~ ~▓~ ~▓~ ~▓~ ~▓~ ~▓~ ~▓~ ~▓~ ~▓~ ~▓~ ~▓~ ~▓~ ~▓~ ~▓~ ~▓~ ~▓~ ~▓~ ~▓~ ~▓~ ~ ~
 ~#~#~#~ ~ ~ ~ ~ ~ ~ ~ ~ ~ ~ ~ ~ ~ ~ ~ ~ ~ ~ ~ ~ ~ ~ ~ ~ ~ ~ ~ ~ ~ ~ ~ ~ ~ ~ ~ ~ ~ ~ ~ ~ ~ ~ ~ ~ ~ ~ ~ ~ ~ ~ ~ ~ ~ ~ ~ ~ ~ ~ ~ ~ ~ ~ ~ ~ ~ ~ ~ ~ ~ ~ ~ ~ ~ ~ ~ ~ ~ ~ ~ ~ ~ ~ ~ ~ ~ ~ ~ ~ ~ ~ ~ ~ ~ ~ ~ ~ ~ ~ ~ ~ ~ ~ ~ ~ ~ ~ ~ ~ ~ ~ ~ ~ ~ ~ ~
 ~ ~▓~#~▓~ ~▓~ ~▓~ ~▓~ ~▓~ ~▓~ ~▓~ ~▓~ ~▓~ ~▓~ ~▓~ ~▓~ ~▓~ ~▓~ ~▓~ ~▓~ ~▓~ ~▓~ ~▓~ ~▓~ ~▓~ ~▓~ ~▓~ ~▓~ ~▓~ ~▓~ ~▓~ ~▓~ ~▓~ ~▓~ ~▓~ ~▓~ ~▓~ ~▓~ ~▓~ ~▓~ ~▓~ ~▓~ ~▓~ ~▓~ ~▓~ ~▓~ ~▓~ ~▓~ ~▓~ ~▓~ ~▓~ ~▓~ ~▓~ ~▓~ ~▓~ ~▓~ ~▓~ ~▓~ ~▓~ ~▓~ ~▓~ ~ ~
 ~#~ ~ ~ ~ ~ ~ ~ ~ ~ ~ ~ ~ ~ ~ ~ ~ ~ ~ ~ ~ ~ ~ ~ ~ ~ ~ ~ ~ ~ ~ ~ ~ ~ ~ ~ ~ ~ ~ ~ ~ ~ ~ ~ ~ ~ ~ ~ ~ ~ ~ ~ ~ ~ ~ ~ ~ ~ ~ ~ ~ ~ ~ ~ ~ ~ ~ ~ ~ ~ ~ ~ ~ ~ ~ ~ ~ ~ ~ ~ ~ ~ ~ ~ ~ ~ ~ ~ ~ ~ ~ ~ ~ ~ ~ ~ ~ ~ ~ ~ ~ ~ ~ ~ ~ ~ ~ ~ ~ ~ ~ ~ ~ ~ ~ ~ ~ ~ ~
 ~ ~▓~ ~▓~#~▓~ ~▓~ ~▓~ ~▓~ ~▓~ ~▓~ ~▓~ ~▓~ ~▓~ ~▓~ ~▓~ ~▓~ ~▓~ ~▓~ ~▓~ ~▓~ ~▓~ ~▓~ ~▓~ ~▓~ ~▓~ ~▓~ ~▓~ ~▓~ ~▓~ ~▓~ ~▓~ ~▓~ ~▓~ ~▓~ ~▓~ ~▓~ ~▓~ ~▓~ ~▓~ ~▓~ ~▓~ ~▓~ ~▓~ ~▓~ ~▓~ ~▓~ ~▓~ ~▓~ ~▓~ ~▓~ ~▓~ ~▓~ ~▓~ ~▓~ ~▓~ ~▓~ ~▓~ ~▓~ ~▓~ ~▓~ ~ ~
 ~ ~ ~ ~ ~#~ ~ ~ ~ ~ ~ ~ ~ ~ ~ ~ ~ ~ ~ ~ ~ ~ ~ ~ ~ ~ ~ ~ ~ ~ ~ ~ ~ ~ ~ ~ ~ ~ ~ ~ ~ ~ ~ ~ ~ ~ ~ ~ ~ ~ ~ ~ ~ ~ ~ ~ ~ ~ ~ ~ ~ ~ ~ ~ ~ ~ ~ ~ ~ ~ ~ ~ ~ ~ ~ ~ ~ ~ ~ ~ ~ ~ ~ ~ ~ ~ ~ ~ ~ ~ ~ ~ ~ ~ ~ ~ ~ ~ ~ ~ ~ ~ ~ ~ ~ ~ ~ ~ ~ ~ ~ ~ ~ ~ ~ ~ ~ ~ ~
 ~ ~▓~ ~▓~ ~▓~ ~▓~ ~▓~ ~▓~ ~▓~ ~▓~ ~▓~ ~▓~ ~▓~ ~▓~ ~▓~ ~▓~ ~▓~ ~▓~ ~▓~ ~▓~ ~▓~ ~▓~ ~▓~ ~▓~ ~▓~ ~▓~ ~▓~ ~▓~ ~▓~ ~▓~ ~▓~ ~▓~ ~▓~ ~▓~ ~▓~ ~▓~ ~▓~ ~▓~ ~▓~ ~▓~ ~▓~ ~▓~ ~▓~ ~▓~ ~▓~ ~▓~ ~▓~ ~▓~ ~▓~ ~▓~ ~▓~ ~▓~ ~▓~ ~▓~ ~▓~ ~▓~ ~▓~ ~▓~ ~▓~ ~▓~ ~ ~
 ~ ~ ~ ~ ~ ~ ~ ~ ~ ~ ~ ~ ~ ~ ~ ~ ~ ~ ~ ~ ~ ~ ~ ~ ~ ~ ~ ~ ~ ~ ~ ~ ~ ~ ~ ~ ~ ~ ~ ~ ~ ~ ~ ~ ~ ~ ~ ~ ~ ~ ~ ~ ~ ~ ~ ~ ~ ~ ~ ~ ~ ~ ~ ~ ~ ~ ~ ~ ~ ~ ~ ~ ~ ~ ~ ~ ~ ~ ~ ~ ~ ~ ~ ~ ~ ~ ~ ~ ~ ~ ~ ~ ~ ~ ~ ~ ~ ~ ~ ~ ~ ~ ~ ~ ~ ~ ~ ~ ~ ~ ~ ~ ~ ~ ~ ~ ~ ~ ~
 ~ ~▓~ ~▓~ ~▓~ ~▓~ ~▓~ ~▓~ ~▓~ ~▓~ ~▓~ ~▓~ ~▓~ ~▓~ ~▓~ ~▓~ ~▓~ ~▓~ ~▓~ ~▓~ ~▓~ ~▓~ ~▓~ ~▓~ ~▓~ ~▓~ ~▓~ ~▓~ ~▓~ ~▓~ ~▓~ ~▓~ ~▓~ ~▓~ ~▓~ ~▓~ ~▓~ ~▓~ ~▓~ ~▓~ ~▓~ ~▓~ ~▓~ ~▓~ ~▓~ ~▓~ ~▓~ ~▓~ ~▓~ ~▓~ ~▓~ ~▓~ ~▓~ ~▓~ ~▓~ ~▓~ ~▓~ ~▓~ ~▓~ ~▓~ ~ ~
 ~ ~ ~ ~ ~ ~ ~ ~ ~ ~ ~ ~ ~ ~ ~ ~ ~ ~ ~ ~ ~ ~ ~ ~ ~ ~ ~ ~ ~ ~ ~ ~ ~ ~ ~ ~ ~ ~ ~ ~ ~ ~ ~ ~ ~ ~ ~ ~ ~ ~ ~ ~ ~ ~ ~ ~ ~ ~ ~ ~ ~ ~ ~ ~ ~ ~ ~ ~ ~ ~ ~ ~ ~ ~ ~ ~ ~ ~ ~ ~ ~ ~ ~ ~ ~ ~ ~ ~ ~ ~ ~ ~ ~ ~ ~ ~ ~ ~ ~ ~ ~ ~ ~ ~ ~ ~ ~ ~ ~ ~ ~ ~ ~ ~ ~ ~ ~ ~ ~
 ~ ~▓~ ~▓~ ~▓~ ~▓~ ~▓~ ~▓~ ~▓~ ~▓~ ~▓~ ~▓~ ~▓~ ~▓~ ~▓~ ~▓~ ~▓~ ~▓~ ~▓~ ~▓~ ~▓~ ~▓~ ~▓~ ~▓~ ~▓~ ~▓~ ~▓~ ~▓~ ~▓~ ~▓~ ~▓~ ~▓~ ~▓~ ~▓~ ~▓~ ~▓~ ~▓~ ~▓~ ~▓~ ~▓~ ~▓~ ~▓~ ~▓~ ~▓~ ~▓~ ~▓~ ~▓~ ~▓~ ~▓~ ~▓~ ~▓~ ~▓~ ~▓~ ~▓~ ~▓~ ~▓~ ~▓~ ~▓~ ~▓~ ~▓~ ~ ~
 ~ ~ ~ ~ ~ ~ ~ ~ ~ ~ ~ ~ ~ ~ ~ ~ ~ ~ ~ ~ ~ ~ ~ ~ ~ ~ ~ ~ ~ ~ ~ ~ ~ ~ ~ ~ ~ ~ ~ ~ ~ ~ ~ ~ ~ ~ ~ ~ ~ ~ ~ ~ ~ ~ ~ ~ ~ ~ ~ ~ ~ ~ ~ ~ ~ ~ ~ ~ ~ ~ ~ ~ ~ ~ ~ ~ ~ ~ ~ ~ ~ ~ ~ ~ ~ ~ ~ ~ ~ ~ ~ ~ ~ ~ ~ ~ ~ ~ ~ ~ ~ ~ ~ ~ ~ ~ ~ ~ ~ ~ ~ ~ ~ ~ ~ ~ ~ ~ ~
 ~ ~▓~ ~▓~ ~▓~ ~▓~ ~▓~ ~▓~ ~▓~ ~▓~ ~▓~ ~▓~ ~▓~ ~▓~ ~▓~ ~▓~ ~▓~ ~▓~ ~▓~ ~▓~ ~▓~ ~▓~ ~▓~ ~▓~ ~▓~ ~▓~ ~▓~ ~▓~ ~▓~ ~▓~ ~▓~ ~▓~ ~▓~ ~▓~ ~▓~ ~▓~ ~▓~ ~▓~ ~▓~ ~▓~ ~▓~ ~▓~ ~▓~ ~▓~ ~▓~ ~▓~ ~▓~ ~▓~ ~▓~ ~▓~ ~▓~ ~▓~ ~▓~ ~▓~ ~▓~ ~▓~ ~▓~ ~▓~ ~▓~ ~▓~ ~ ~
 ~ ~ ~ ~ ~ ~ ~ ~ ~ ~ ~ ~ ~ ~ ~ ~ ~ ~ ~ ~ ~ ~ ~ ~ ~ ~ ~ ~ ~ ~ ~ ~ ~ ~ ~ ~ ~ ~ ~ ~ ~ ~ ~ ~ ~ ~ ~ ~ ~ ~ ~ ~ ~ ~ ~ ~ ~ ~ ~ ~ ~ ~ ~ ~ ~ ~ ~ ~ ~ ~ ~ ~ ~ ~ ~ ~ ~ ~ ~ ~ ~ ~ ~ ~ ~ ~ ~ ~ ~ ~ ~ ~ ~ ~ ~ ~ ~ ~ ~ ~ ~ ~ ~ ~ ~ ~ ~ ~ ~ ~ ~ ~ ~ ~ ~ ~ ~ ~ ~
 ~ ~▓~ ~▓~ ~▓~ ~▓~ ~▓~ ~▓~ ~▓~ ~▓~ ~▓~ ~▓~ ~▓~ ~▓~ ~▓~ ~▓~ ~▓~ ~▓~ ~▓~ ~▓~ ~▓~ ~▓~ ~▓~ ~▓~ ~▓~ ~▓~ ~▓~ ~▓~ ~▓~ ~▓~ ~▓~ ~▓~ ~▓~ ~▓~ ~▓~ ~▓~ ~▓~ ~▓~ ~▓~ ~▓~ ~▓~ ~▓~ ~▓~ ~▓~ ~▓~ ~▓~ ~▓~ ~▓~ ~▓~ ~▓~ ~▓~ ~▓~ ~▓~ ~▓~ ~▓~ ~▓~ ~▓~ ~▓~ ~▓~ ~▓~ ~ ~
 ~ ~ ~ ~ ~ ~ ~ ~ ~ ~ ~ ~ ~ ~ ~ ~ ~ ~ ~ ~ ~ ~ ~ ~ ~ ~ ~ ~ ~ ~ ~ ~ ~ ~ ~ ~ ~ ~ ~ ~ ~ ~ ~ ~ ~ ~ ~ ~ ~ ~ ~ ~ ~ ~ ~ ~ ~ ~ ~ ~ ~ ~ ~ ~ ~ ~ ~ ~ ~ ~ ~ ~ ~ ~ ~ ~ ~ ~ ~ ~ ~ ~ ~ ~ ~ ~ ~ ~ ~ ~ ~ ~ ~ ~ ~ ~ ~ ~ ~ ~ ~ ~ ~ ~ ~ ~ ~ ~ ~ ~ ~ ~ ~ ~ ~ ~ ~ ~ ~
 ~ ~▓~ ~▓~ ~▓~ ~▓~ ~▓~ ~▓~ ~▓~ ~▓~ ~▓~ ~▓~ ~▓~ ~▓~ ~▓~ ~▓~ ~▓~ ~▓~ ~▓~ ~▓~ ~▓~ ~▓~ ~▓~ ~▓~ ~▓~ ~▓~ ~▓~ ~▓~ ~▓~ ~▓~ ~▓~ ~▓~ ~▓~ ~▓~ ~▓~ ~▓~ ~▓~ ~▓~ ~▓~ ~▓~ ~▓~ ~▓~ ~▓~ ~▓~ ~▓~ ~▓~ ~▓~ ~▓~ ~▓~ ~▓~ ~▓~ ~▓~ ~▓~ ~▓~ ~▓~ ~▓~ ~▓~ ~▓~ ~▓~ ~▓~ ~ ~
 ~ ~ ~ ~ ~ ~ ~ ~ ~ ~ ~ ~ ~ ~ ~ ~ ~ ~ ~ ~ ~ ~ ~ ~ ~ ~ ~ ~ ~ ~ ~ ~ ~ ~ ~ ~ ~ ~ ~ ~ ~ ~ ~ ~ ~ ~ ~ ~ ~ ~ ~ ~ ~ ~ ~ ~ ~ ~ ~ ~ ~ ~ ~ ~ ~ ~ ~ ~ ~ ~ ~ ~ ~ ~ ~ ~ ~ ~ ~ ~ ~ ~ ~ ~ ~ ~ ~ ~ ~ ~ ~ ~ ~ ~ ~ ~ ~ ~ ~ ~ ~ ~ ~ ~ ~ ~ ~ ~ ~ ~ ~ ~ ~ ~ ~ ~ ~ ~ ~
 ~ ~▓~ ~▓~ ~▓~ ~▓~ ~▓~ ~▓~ ~▓~ ~▓~ ~▓~ ~▓~ ~▓~ ~▓~ ~▓~ ~▓~ ~▓~ ~▓~ ~▓~ ~▓~ ~▓~ ~▓~ ~▓~ ~▓~ ~▓~ ~▓~ ~▓~ ~▓~ ~▓~ ~▓~ ~▓~ ~▓~ ~▓~ ~▓~ ~▓~ ~▓~ ~▓~ ~▓~ ~▓~ ~▓~ ~▓~ ~▓~ ~▓~ ~▓~ ~▓~ ~▓~ ~▓~ ~▓~ ~▓~ ~▓~ ~▓~ ~▓~ ~▓~ ~▓~ ~▓~ ~▓~ ~▓~ ~▓~ ~▓~ ~▓~ ~ ~
 ~ ~ ~ ~ ~ ~ ~ ~ ~ ~ ~ ~ ~ ~ ~ ~ ~ ~ ~ ~ ~ ~ ~ ~ ~ ~ ~ ~ ~ ~ ~ ~ ~ ~ ~ ~ ~ ~ ~ ~ ~ ~ ~ ~ ~ ~ ~ ~ ~ ~ ~ ~ ~ ~ ~ ~ ~ ~ ~ ~ ~ ~ ~ ~ ~ ~ ~ ~ ~ ~ ~ ~ ~ ~ ~ ~ ~ ~ ~ ~ ~ ~ ~ ~ ~ ~ ~ ~ ~ ~ ~ ~ ~ ~ ~ ~ ~ ~ ~ ~ ~ ~ ~ ~ ~ ~ ~ ~ ~ ~ ~ ~ ~ ~ ~ ~ ~ ~ ~
 ~ ~▓~ ~▓~ ~▓~ ~▓~ ~▓~ ~▓~ ~▓~ ~▓~ ~▓~ ~▓~ ~▓~ ~▓~ ~▓~ ~▓~ ~▓~ ~▓~ ~▓~ ~▓~ ~▓~ ~▓~ ~▓~ ~▓~ ~▓~ ~▓~ ~▓~ ~▓~ ~▓~ ~▓~ ~▓~ ~▓~ ~▓~ ~▓~ ~▓~ ~▓~ ~▓~ ~▓~ ~▓~ ~▓~ ~▓~ ~▓~ ~▓~ ~▓~ ~▓~ ~▓~ ~▓~ ~▓~ ~▓~ ~▓~ ~▓~ ~▓~ ~▓~ ~▓~ ~▓~ ~▓~ ~▓~ ~▓~ ~▓~ ~▓~ ~ ~
 ~ ~ ~ ~ ~ ~ ~ ~ ~ ~ ~ ~ ~ ~ ~ ~ ~ ~ ~ ~ ~ ~ ~ ~ ~ ~ ~ ~ ~ ~ ~ ~ ~ ~ ~ ~ ~ ~ ~ ~ ~ ~ ~ ~ ~ ~ ~ ~ ~ ~ ~ ~ ~ ~ ~ ~ ~ ~ ~ ~ ~ ~ ~ ~ ~ ~ ~ ~ ~ ~ ~ ~ ~ ~ ~ ~ ~ ~ ~ ~ ~ ~ ~ ~ ~ ~ ~ ~ ~ ~ ~ ~ ~ ~ ~ ~ ~ ~ ~ ~ ~ ~ ~ ~ ~ ~ ~ ~ ~ ~ ~ ~ ~ ~ ~ ~ ~ ~ ~
 ~ ~▓~ ~▓~ ~▓~ ~▓~ ~▓~ ~▓~ ~▓~ ~▓~ ~▓~ ~▓~ ~▓~ ~▓~ ~▓~ ~▓~ ~▓~ ~▓~ ~▓~ ~▓~ ~▓~ ~▓~ ~▓~ ~▓~ ~▓~ ~▓~ ~▓~ ~▓~ ~▓~ ~▓~ ~▓~ ~▓~ ~▓~ ~▓~ ~▓~ ~▓~ ~▓~ ~▓~ ~▓~ ~▓~ ~▓~ ~▓~ ~▓~ ~▓~ ~▓~ ~▓~ ~▓~ ~▓~ ~▓~ ~▓~ ~▓~ ~▓~ ~▓~ ~▓~ ~▓~ ~▓~ ~▓~ ~▓~ ~▓~ ~▓~ ~ ~
 ~ ~ ~ ~ ~ ~ ~ ~ ~ ~ ~ ~ ~ ~ ~ ~ ~ ~ ~ ~ ~ ~ ~ ~ ~ ~ ~ ~ ~ ~ ~ ~ ~ ~ ~ ~ ~ ~ ~ ~ ~ ~ ~ ~ ~ ~ ~ ~ ~ ~ ~ ~ ~ ~ ~ ~ ~ ~ ~ ~ ~ ~ ~ ~ ~ ~ ~ ~ ~ ~ ~ ~ ~ ~ ~ ~ ~ ~ ~ ~ ~ ~ ~ ~ ~ ~ ~ ~ ~ ~ ~ ~ ~ ~ ~ ~ ~ ~ ~ ~ ~ ~ ~ ~ ~ ~ ~ ~ ~ ~ ~ ~ ~ ~ ~ ~ ~ ~ ~
 ~ ~▓~ ~▓~ ~▓~ ~▓~ ~▓~ ~▓~ ~▓~ ~▓~ ~▓~ ~▓~ ~▓~ ~▓~ ~▓~ ~▓~ ~▓~ ~▓~ ~▓~ ~▓~ ~▓~ ~▓~ ~▓~ ~▓~ ~▓~ ~▓~ ~▓~ ~▓~ ~▓~ ~▓~ ~▓~ ~▓~ ~▓~ ~▓~ ~▓~ ~▓~ ~▓~ ~▓~ ~▓~ ~▓~ ~▓~ ~▓~ ~▓~ ~▓~ ~▓~ ~▓~ ~▓~ ~▓~ ~▓~ ~▓~ ~▓~ ~▓~ ~▓~ ~▓~ ~▓~ ~▓~ ~▓~ ~▓~ ~▓~ ~▓~ ~ ~
 ~ ~ ~ ~ ~ ~ ~ ~ ~ ~ ~ ~ ~ ~ ~ ~ ~ ~ ~ ~ ~ ~ ~ ~ ~ ~ ~ ~ ~ ~ ~ ~ ~ ~ ~ ~ ~ ~ ~ ~ ~ ~ ~ ~ ~ ~ ~ ~ ~ ~ ~ ~ ~ ~ ~ ~ ~ ~ ~ ~ ~ ~ ~ ~ ~ ~ ~ ~ ~ ~ ~ ~ ~ ~ ~ ~ ~ ~ ~ ~ ~ ~ ~ ~ ~ ~ ~ ~ ~ ~ ~ ~ ~ ~ ~ ~ ~ ~ ~ ~ ~ ~ ~ ~ ~ ~ ~ ~ ~ ~ ~ ~ ~ ~ ~ ~ ~ ~ ~
 ~ ~▓~ ~▓~ ~▓~ ~▓~ ~▓~ ~▓~ ~▓~ ~▓~ ~▓~ ~▓~ ~▓~ ~▓~ ~▓~ ~▓~ ~▓~ ~▓~ ~▓~ ~▓~ ~▓~ ~▓~ ~▓~ ~▓~ ~▓~ ~▓~ ~▓~ ~▓~ ~▓~ ~▓~ ~▓~ ~▓~ ~▓~ ~▓~ ~▓~ ~▓~ ~▓~ ~▓~ ~▓~ ~▓~ ~▓~ ~▓~ ~▓~ ~▓~ ~▓~ ~▓~ ~▓~ ~▓~ ~▓~ ~▓~ ~▓~ ~▓~ ~▓~ ~▓~ ~▓~ ~▓~ ~▓~ ~▓~ ~▓~ ~▓~ ~ ~
 ~ ~ ~ ~ ~ ~ ~ ~ ~ ~ ~ ~ ~ ~ ~ ~ ~ ~ ~ ~ ~ ~ ~ ~ ~ ~ ~ ~ ~ ~ ~ ~ ~ ~ ~ ~ ~ ~ ~ ~ ~ ~ ~ ~ ~ ~ ~ ~ ~ ~ ~ ~ ~ ~ ~ ~ ~ ~ ~ ~ ~ ~ ~ ~ ~ ~ ~ ~ ~ ~ ~ ~ ~ ~ ~ ~ ~ ~ ~ ~ ~ ~ ~ ~ ~ ~ ~ ~ ~ ~ ~ ~ ~ ~ ~ ~ ~ ~ ~ ~ ~ ~ ~ ~ ~ ~ ~ ~ ~ ~ ~ ~ ~ ~ ~ ~ ~ ~ ~
 ~ ~▓~ ~▓~ ~▓~ ~▓~ ~▓~ ~▓~ ~▓~ ~▓~ ~▓~ ~▓~ ~▓~ ~▓~ ~▓~ ~▓~ ~▓~ ~▓~ ~▓~ ~▓~ ~▓~ ~▓~ ~▓~ ~▓~ ~▓~ ~▓~ ~▓~ ~▓~ ~▓~ ~▓~ ~▓~ ~▓~ ~▓~ ~▓~ ~▓~ ~▓~ ~▓~ ~▓~ ~▓~ ~▓~ ~▓~ ~▓~ ~▓~ ~▓~ ~▓~ ~▓~ ~▓~ ~▓~ ~▓~ ~▓~ ~▓~ ~▓~ ~▓~ ~▓~ ~▓~ ~▓~ ~▓~ ~▓~ ~▓~ ~▓~ ~ ~
 ~ ~ ~ ~ ~ ~ ~ ~ ~ ~ ~ ~ ~ ~ ~ ~ ~ ~ ~ ~ ~ ~ ~ ~ ~ ~ ~ ~ ~ ~ ~ ~ ~ ~ ~ ~ ~ ~ ~ ~ ~ ~ ~ ~ ~ ~ ~ ~ ~ ~ ~ ~ ~ ~ ~ ~ ~ ~ ~ ~ ~ ~ ~ ~ ~ ~ ~ ~ ~ ~ ~ ~ ~ ~ ~ ~ ~ ~ ~ ~ ~ ~ ~ ~ ~ ~ ~ ~ ~ ~ ~ ~ ~ ~ ~ ~ ~ ~ ~ ~ ~ ~ ~ ~ ~ ~ ~ ~ ~ ~ ~ ~ ~ ~ ~ ~ ~ ~ ~